...................................................
...................................................
...................................................
...................................................
...................................................
..........................#####....................
.............#####..................#..#...........
...................................................
.....#####.......#.................................
......................................#.#..........
......................................#............
.........#####...................#.................
...................................................
..............#.........####.......................
..............#....................................
..............#....................................
..............#......................#####.........
.....#####.........................................
.........................#####.....................
...................................................
.....##############................................
...................................................
...................................................
...................................................
.....##############................................
...................................................
......................................#............
......................................#............
................###############.......#............
......................................#............
......................................#............
......##.##...........................#............
......#...#........#..................#............
......#...#........#..................#............
......#...#........#..................#............
......#...#........#..................#............
...................#..................#............
...................#...............................
...................#...............................
...................#...............................
...................#...............................
...................#...............................
...................#...............................
...................#...............................
...................#...............................
...................................................
...................................................
...................................................
...................................................
...................................................
