...................................................
...................................................
...................................................
...................................................
.........#.....#.....#.....#.....#.................
.........#.....#.....#.....#.....#.................
.........#.....#.....#.....#.....#.................
.........#.....#.....#.....#.....#.................
.........#.....#.....#.....#.....#.................
.........#.....#.....#.....#.....#.................
.........#.....#.....#.....#.....#.................
.........#.....#.....#.....#.....#.................
.........#.....#.....#.....#.....#.................
.........#.....#.....#.....#.....#.................
...................................................
...................................................
...................................................
...................................................
...................................................
........######....#######....######................
...................................................
...................................................
...................................................
...................................................
........######....#######....######................
...................................................
...................................................
...................................................
...................................................
...................................................
........######....#######....######................
...................................................
...................................................
...................................................
...................................................
...................................................
.........#.....#.....#.....#.....#.................
.........#.....#.....#.....#.....#.................
.........#.....#.....#.....#.....#.................
.........#.....#.....#.....#.....#.................
.........#.....#.....#.....#.....#.................
.........#.....#.....#.....#.....#.................
.........#.....#.....#.....#.....#.................
.........#.....#.....#.....#.....#.................
.........#.....#.....#.....#.....#.................
.........#.....#.....#.....#.....#.................
...................................................
...................................................
...................................................
...................................................
